WWWWWWWWWW
W        W
W AHHHY  W
W    b   W
W  S WXXWW
W    W
W B   W  W
W A  W   W
W YF     W
WWWWWWWWWW