WWWWWWWWWW
W   B b  W
W AHHHY  W
W     AA W
W    WXXWW
W    W
W    W   W
W    W   W
WS  R    W
WWWWWWWWWW