WWWWWWWWWW
W  B     W
W  HHHY  W
W A   T  W
W    WXXWW
W C  W
W  S W   W
W  b W   W
W        W
WWWWWWWWWW