WWWWWWWWWW
W  B     W
W  HHHH  W
W  T     W
W    WWWWW
W    W
W  S W   W
W    W   W
W  C     W
WWWWWWWWWW