WWWWWWWWWW
W B  R   W
W S  R   W
W    Rb  W
W  HHHH  W
W        W
W    AXXXW
W    X    
W    X   W
WWWWWWWWWW