WWWWWWWWWW
W   B    W
W THHHY  W
W      R W
W SHHWXXWW
W    W
W    W   W
W  R W   W
W YF     W
WWWWWWWWWW