WWWWWWWWWW
W   B b  W
W THHHY  W
W     R AW
W S  WXXWW
W    W
W    W   W
W  R W   W
W  F     W
WWWWWWWWWW