WWWWWWWWWW
W  CC    W
W  HHHY  W
W      R W
W    WXXWW
W    W
W A  W   W
W    W   W
W     BS W
WWWWWWWWWW