WWWWWWWWWW
W  CC    W
W  HHHY  W
W      R W
W    WXXWW
W    W
W A  W   W
W B SW   W
W        W
WWWWWWWWWW