WWWWWWWWWW
W  B     W
W  HHHH  W
W A      W
W    WXXWW
W    W
W  S W   W
W  b W   W
W        W
WW WWWWWWW