WWWWWWWWWW
W  B     W
WA HHHH  W
W        W
W    WXXWW
W    W
W   SW   W
W   bW   W
W        W
WW WWWWWWW