WWWWWWWWWW
W A  C   W
W  HHHY  W
W    CT  W
W    WXXWW
W    W
W A CW   W
W B SW   W
W        W
WWWWWWWWWW